0000000000000000000000000000000000000000000000000000000000000000000000000000000000000000000000000000000000000000000000000000000000000000000000000000000000000000000000000000000000000000|
0000000000000000000000000000000000000000000000000000000000000000000000000000000000000000000000000000000000000000000000000000000000000000000000000000000000000000000000000000000000000000|
0000000000000000000000000000000000000000000000000000000000000000000000000000000000000000000000000000000000000000000000000000000000000000000000000000000000000000000000000000000000000000|
0000000000000000000000000000000000000000000000000000000000000000000000000000000000000000000000000000000000000000000000000000000000000000000000000000000000000000000000000000000000000000|
0000000000000000000000000000000000000000000000000000000000000000000000000000000000000000000000000000000000000000000000000000000000000000000000000000000000000000000000000000000000000000|
0000000000000000000000000000000000000000000000000000000000000000000000000000000000000000000000000000000000000000000000000000000000000000000000000000000000000000000000000000000000000000|
0000000000000000000000000000000000000000000000000000000000000000000000000000000000000000000000000000000000000000000000000000000000000000000000000000000000000000000000000000000000000000|
0000000000000000000000000000000000000000000000000000000000000000000000000000000000000000000000000000000000000000000000000000000000000000000000000000000000000000000000000000000000000000|
0000000000000000000000000000000000000000000000000000000000000000000000000000000000000000000000000000000000000000000000000000000000000000000000000000000000000000000000000000000000000000|
0000000000000000000000000000000000000000000000000000000000000000000000000000000000000000000000000000000000000000000000000000000000000000000000000000000000000000000000000000000000000000|
0000000000000000000000000000000000000000000000000000000000000000000000000000000000000000000000000000___000000000000000000000000000000000000000000000000000000000000000000000000000000000|
00000000000000000000000000000000000000000000000000003000000000000000000000000000000000000000000___0000000___0000000000000000000000000000000000000000000000000000000000000000000000000000|
00000000000000000000000000000000000000000000000000007000000000000000000000000000000000000___000000000000000000___000000000000000000000000000000000000000___00000000000000000000000000000|
0000000000000000000000000011100000000000000000000000000000000000000000000000000000001110000000000000000000000000000___00000000000000000000000000000___0000000___000000000000000000000000|
000@00000000000000000001112220000000000000000000000000000000000000000000000000000111222000000000000000000000000000000000___0000000000000000000___00000000000000000___0000000000000000000|
00000000000000000000111222222444400000000400000000004000000000000000000000000011122222200000000000000000000000000000000000000___00000000000111444400000000000000000000000000000000000000|
11111111111111111111222222222111111111111111111111111111111111111111111111111122222222244444444444444444444444444444444444444444411111111112221111111111111111111111111111111111111111111
22222222222222222222222222222222222222222222222222222222222222222222222222222222222222222222222222222222222222222222222222222222222222222222222222222222222222222222222222222222222222222