0000000000000000000000000000000000000000000000000000000000000000000000000000000000000000000000000000000000000000000000000000000000000000000000000000000000000000000000000000000000000000000000000000000000000000000000000000000000000000000000|
0000000000000000000000000000000000000000000000000000000000000000000000000000000000000000000000000000000000000000000000000000000000000000000000000000000000000000000000000000000000000000000000000000000000000000000000000000000000000000000000|
0000000000000000000000000000000000000000000000000000000000000000000000000000000000000000000000000000000000000000000000000000000000000000000000000000000000000000000000000000000000000000000000000000000000000000000000000000000000000000000000|
0000000000000000000000000000000000000000000000000000000000000000000000000000000000000000000000000000000000000000000000000000000000000000000000000000000000000000000000000000000000000000000000000000000000000000000000000000000000000000000000|
00000000000000000000000000000000000000000000000000000000000000000000000000000000000000000000000000000000000000000000000000000000000000000000000000000000000000000000000000000000000000000000000000000000000000000000000000000000000___00000000|
000000000000000000000000000000000000000000000000000000000000000000000000000000000000000000000000000000000000000000000000000000000000000000000000000000000000000000000000000000000000000000000000000000000000000000000000000000___0000000000000|
0000000000000000000000000000000000000000000000000000000000000000000000000000000000000000000000000000000000000000000000000000000000000000000000000000000000000000000000000000000000000000000000000000000000000000000000000___000000000000000000|
00000000000000000000000000000000000000000000000000000000000000000000000000000000000000000000000000000000000000000000000000000000000000000000000000000000000000000000000000000000000000000000000000000000000000000000___00000000000000000000000|
000000000000000000000000000000000000000000000000000000000000000000000000000000000000000000000000000000000000000400000000000000000000000000000000000000000000000000000000000000000000000000000000000000000000000___0000000000000000000000000000|
0000000000000000000000000000000000000000000000000000000000000000000000000000000000000000000000400000000________0_________000000000000000000000000000000000000000000000000000000000000000000000000000000000___000000000000000000000000000000000|
00000000000000000000000000000000000000000000000000000000400000000000004_____400000000000______0______0000000000000000000000_____000000000000000000000000000000000000000000000000000000000000000000000___00000000000000000000000000000000000000|
000000000000000000000000000000000000000000000000111_____0_____________0000000__________4000000000000000000000000000000000000000000_____000000000000000000000000000000000000000000000000000000000___0000000000000000000000000000000000000000000|
00000000000000000000000000000000000000000001110022200000000000000000000000000000000000000000000000000000000000000000000000000000000000000____0000000000000000000000000000000000000000000000___000000000000000000000000000000000000000000000000|
00000000000000000000000000111000111000111002220022200000000000000000000000000000000000000000000000000000000000000000000000000000000000000000000____00000000000000000000000000000000000___00000000000000000000000000000000000000000000000000000|
000@0000000000000000000111222000222000222002220022200000000000000000000000000000000000000000000000000000000000000000000000000000000000000000000000000____000000000000000000000000___0000000000000000000000000000000000000000000000000000000000|
0000000000000000000011122222244422244422244222442224444444444444444444444444444444444444444444444444444444444444444444444444444444444444444444444444444444400000000040000000___004444444444444444444444444444444444444444444444444444444444444|
11111111111111111111222222222111111111222111222111111111111111111111111111111111111111111111111111111111111111111111111111111111111111111111111111111111111111111111111111111111111111111111111111111111111111111111111111111111111111111111111
22222222222222222222222222222222222222222222222222222222222222222222222222222222222222222222222222222222222222222222222222222222222222222222222222222222222222222222222222222222222222222222222222222222222222222222222222222222222222222222222