0000000000000000000000000000000000000000000000000000000000000000000000000000000000000000000000000000000000000000000000000000000000000000000000000000000000000000000000000000000000000000000000000000000000000000000000000000000000000000000000000000000000000000000000000000000|
0000000000000000000000000000000000000000000000000000000000000000000000000000000000000000000000000000000000000000000000000000000000000000000000000000000000000000000000000000000000000000000000000000000000000000000000000000000000000000000000000000000000000000000000000000000|
0000000000000000000000000000000000000000000000000000000000000000000000000000000000000000000000000000000000000000000000000000000000000000000000000000000000000000000000000000000000000000000000000000000000000000000000000000000000000000000000000000000000000000000000000000000|
0000000000000000000000000000000000000000000000000000000000000000000000000000000000000000000000000000000000000000000000000000000000000000000000000000000000000000000000000000000000000000000000000000000000000000000000000000000000000000000000000000000000000000000000000000000|
0000000000000000000000000000000000000000000000000000000000000000000000000000000000000000000000000000000000000000000000000000000000000000000000000000000000000000000000000000000000000000000000000000000000000000000000000000000000000000000000000000000000000000000000000000000|
0000000000000000000000000000000000000000000000000000000000000000000000000000000000000000000000000000000000000000000000000000000000000000000000000000000000000000000000000000000000000000000000000000000000000000000000000000000000000000000000000000000000000000000000000000000|
0000000000000000000000000000000000000000000000000000000000000000000000000000000000000000000000000000000000000000000000000000000000000000000000000000000000000000000000000000000000000000000000000000000000000000000000000000000000000000000000000000000000000000000000000000000|
0000000000000000000000000000000000000000000000000000000000000000000000000000000000000000000000000000000000000000000000000000000000000000000000000000000000000000000000000000000000000000000000000000000000000000000000000000000000000000000000000000000000000000000000000000000|
0000000000000000000000000000000000000000000000000000000000000000000000000000000000000000000000000000000000000000000000000000000000000000000000000000000000000000000000000000000000000000000000000000000000000000000000000000000000000000000000000000000000000000000000000000000|
000000000000000000000000000000000000000000000000000000000000000000000000000000000000000000000000000000000000000000000000000000000000000000000000000000000000000000000000000000000000000000$000000000000000000000000000000000000000000000000000000000000000000000000000000000000|
000000000000000000000000000000000000000000000000000000000000000000000000000000000000000000000000000000000000000000000000000000000000000000000000000000000000000000000000000000000000000___0000000000000000003333333333333333333333333333333333333333333333333333333333333333333|
00000000000000000000000000000000000000000000000000000000000000000000000000000000000000000000000004_____000000000000000000000000000000000000400000000000040000000000000000000000000___000000000000000000000007777777777777777777777777777777777777777777777777777777777777777777|
00000000000000000000000000000000000000000000000000000000000000000000000000000000400000000000_____00000000___000000000000000000001111111111111111111111111111111110000000_________0000000000000000000000000000000000000000000000000000000000000000000000000000000000000000000000|
00000000000000000000000000000000000000000000000000000000000000000001111111111111111111111100000000000000000000___00000000000011122200000000000000000000000000000011100000000000000000000000000000000000000001111111111111111111111111111111111111111111111111111111111111111111|
000@000000000000000000000000000000000000000000000000000000000000111222000000000000000000000000000000000000000000000___000011122222200000000000000000000000000000022211100000000000000000000000000000000001112220000000000000000000000000000000000000000000000000000000000000000|
0000000000000000000000000000000000000000400000000400000000000111222222444444444444444444444444444444444444444444444444411122222222200000000000000000000000000000022222211100000000000004000000000000001112222220000000000000000000000000000000000000000000000000000000000000000|
11111111111111111111111111111111111111112111111112111111111112222222221111111111111111111111111111111111111111111111111222222222222111111111111111111111111111111222222222111111111111111111111111111122222222211111111111111111111111111111111111111111111111111111111111111111
22222222222222222222222222222222222222222222222222222222222222222222222222222222222222222222222222222222222222222222222222222222222222222222222222222222222222222222222222222222222222222222222222222222222222222222222222222222222222222222222222222222222222222222222222222222