0000000000000000000000000000000000000000000000000000000000000000000000000000000000000000000000000000000000000000000000000000000000000000000000000000000000000000000000000000000000000000000000000000000000000000000000000000000000000000000000000000000000000000000000000000000|
0000000000000000000000000000000000000000000000000000000000000000000000000000000000000000000000000000000000000000000000000000000000000000000000000000000000000000000000000000000000000000000000000000000000000000000000000000000000000000000000000000000000000000000000000000000|
0000000000000000000000000000000000000000000000000000000000000000000000000000000000000000000000000000000000000000000000000000000000000000000000000000000000000000000000000000000000000000000000000000000000000000000000000000000000000000000000000000000000000000000000000000000|
0000000000000000000000000000000000000000000000000000000000000000000000000000000000000000000000000000000000000000000000000000000000000000000000000000000000000000000000000000000000000000000000000000000000000000000000000000000000000000000000000000000000000000000000000000000|
0000000000000000000000000000000000000000000000000000000000000000000000000000000000000000000000000000000000000000000000000000000000000000000000000000000000000000000000000000000000000000000000000000000000000000000000000000000000000000000000000000000000000000000000000000000|
0000000000000000000000000000000000000000000000000000000000000000000000000000000000000000000000000000000000000000000000000000000000000000000000000000000000000000000000000000000000000000000000000000000000000000000000000000000000000000000000000000000000000000000000000000000|
0000000000000000000000000000000000000000000000000000000000000000000000000000000000000000000000000000000000000000000000000000000000000000000000000000000000000000000000000000000000000000000000000000000000000000000000000000000000000000000000000000000000000000000000000000000|
0000000000000000000000000000000000000000000000000000000000000000000000000000000000000000000000000000000000000000000000000000000000000000000000000000000000000000000000000000000000000000000000000000000000000000000000000000000000000000000000000000000000000000000000000000000|
0000000000000000000000000000000000000000000000000000000000000000000000000000000000000000000000000000000000000000000000000000000000000000000000000000000000000000000000000000000000000000000000000000000000000000000000000000000000000000000000000000000000000000000000000000000|
0000000000000000000000000000000000000000000000000000000000000000000000000000000000000000000000000000000000000000000000000000000000000000000000000000000000000000000000000000000000000000000000000000000000000000000000000000000000000000000000000000000000000000000000000000000|
000000000000000000000000000000000000000000000000000000000000000000000000000000000000000000000000000___0000000000000000000000000000000000000000000000000000000000000000000000000000000000000000000000000000000000000000000000000000000000000000000000000000000000000000000000000|
00000000000000000000000000000000000000000000000000003000003000000000000000000000000000000000000___00000000___000000000000000000000000000000000000000000000000000000000000000000000000000000000000000000000000000000000000000000000000000000000000000000000000000000000000000000|
00000000000000000000000000000000000000000011100000000007000007000000000000000000000000000000____000000000000000000___0000000000000000000000000000000000000000___000000000000000000000000000000000000000000000000000000000000000000000000000000000000000000000000000000000000000000|
000000000000000000000000001110001110000111222000000000000000000000000000000000000000000001110000000000000000000000000000___000000000000000000000000000000___00000000___0000000000000000000000000000000000000000000000000000000000000000000000000000000000000000000000000000000000000|
000000000@000000000000011122200022200002222220000000000000000000000000000000000000011122200000000000000000000000000000000___00000000000000000000___0000000000000000000___00000000000000000000000000000000000000000000000000000000000000000000000000000000000000000000000000000000|
00000000000000000000111222222444222044422222200000400000400000000000000000001112222220000000000000000000000000000000000000___00000000000___444444000000$000000000000000000000000000000000000000000000000000000000000000000000000000000000000000000000000000000000000000000000|
11111111111111111111222222222111111111111111111111111111111111111111111111111122222222244444444444444444444444444444444444422211111111111122222221111111111111111111111111111111111111111111111111111111111111111111111111111111111111111111111111111111111111111111111111111111
22222222222222222222222222222222222222222222222222222222222222222222222222222222222222222222222222222222222222222222222222222222222222222222222222222222222222222222222222222222222222222222222222222222222222222222222222222222222222222222222222222222222222222222222222222222