...###.....
..##.#....#
.....###..#
##....@...#
#......#..#
###..#.#..#
..#..#....#
#....#.#.##
#.......##
#......##
..#####...