###########
#.##.#....#
#....###..#
##........#
#......#..#
###..#.#..#
#.#..#....#
#....#.#.##
#.......###
#...@.....#
###########