............######
#.................
#........####.....
####....@...#.....
#...........#.....
#.................
..................
